11111111111111
1P00C001000001
1000C001000001
1000C001001111
1000C0010E00C1
1C000000011111
11111111111111
